11100000111111111111
10001010000000000001
10101011111011111101
00101010000000001001
10101011111111101011
10101000000000101001
10101111111110101101
10100100000000000001
10111111111101111111
00001000101000000000
11100010101011111010
10111110000000001010
00000010111111101010
01111000000000100010
01000011111101101010
01011010000000101010
00010010111110101010
01111010100010101010
00001010111010101010
10100010000010001000